1111111111111111111111111111111111
1000000000000000000000000000000001
1010000000000000000000000000000001
1010000000000000000000000000000001
1010000000000000000000000000000001
1010000000000000000000000000000001
1000000000000000000000000000000001
1000000000000000000000000000000001
1000000000000000000000000000000001
1000000000000000000000000000000001
1000000000000000000000000000000001
1010000000000000000000000000000001
1110100000000000000000000000000001
1000100000000000000000000000000001
1011100000000000000000000000000001
1010000000000000000000000000000001
1010000000000000000000000000000001
1111111111111111111111111111111111
