1111111111111111111111111111111111
1C00000000000000000000000000000001
1010000000000000000000000000000001
10100000000000E0000000000000000001
1010000000000000000000000000000001
101000000000000000000000C000000001
1000000000000000000000000000000001
1000000000000000000000000000000001
1000000000000000000000000000000001
10C00000000000000000000000P0000001
1000000000000000000000000000000001
1010000000000000000000000000000001
1110100000000000000000000000000001
1000100000000000000000000000000001
1011100000000000000000000000000001
10100000000000000000000000000E0001
10100000000000000C0000000000000001
1111111111111111111111111111111111
